💖   ~   python3                                                                    11:49:47 
Python 3.13.2 (main, Feb  4 2025, 14:51:09) [Clang 16.0.0 (clang-1600.0.26.6)] on darwin
Type "help", "copyright", "credits" or "license" for more information.
>>> def a(s):
...     sum = 1
...     for c in s:
...         sum *= ord(c)
...         
>>> def a(s):
...     sum = 1
...     for c in s:
...         sum *= ord(c)
...     return sum
...     
>>> a('_Ar')
703950
>>> 377910/703950
0.5368421052631579
>>> 377910/ord('_')
3978.0
>>> 377910/ord('A')
5814.0
>>> 377910/ord('r')
3315.0
>>>  3978.0 / ord('A')
  File "<python-input-7>", line 1
    3978.0 / ord('A')
IndentationError: unexpected indent
>>> 3978.0 / ord('A')
61.2
>>> 377910/a('_A')
61.2
>>> 377910/a('Ar')
51.0
>>> chr(51)
'3'
>>> 445536/a('_T')
55.83157894736842
>>> 445536/a('XZ')
56.25454545454546
>>> 445536/a('_T')
55.83157894736842
>>> 445536/a('T0')
110.5
>>> 445536/a('T2')
106.08
>>> 445536/a('T2'1
  File "<python-input-17>", line 1
    445536/a('T2'1
            ^
SyntaxError: '(' was never closed
>>> 445536/a('T2')
106.08
>>> 445536/a('T1')
108.24489795918367
>>> 445536/a('T3')
104.0
>>> 445536/a('T3')
104.0
>>> 41637750/a(''n3)
  File "<python-input-22>", line 1
    41637750/a(''n3)
               ^^^^
SyntaxError: invalid syntax. Perhaps you forgot a comma?
>>> 41637750/a('n3')
7422.058823529412
>>> 41637750/a('n3a')
76.51607034566403
>>> 41637750/a('na4')
75.04460745440127
>>> 41637750/a('na1')
79.63917525773196
>>> 41637750/a('na0')
81.29832474226804
>>> 41637750/a('na3')
76.51607034566403
>>> 41637750/a('na4')
75.04460745440127
>>> 41637750/a('na5')
73.62867146469559
>>> 41637750/a('na6')
72.2651775486827
>>> 41637750/a('na7')
70.95126522961574
>>> 41637750/a('na8')
69.68427835051547
>>> 41637750/a('na9')
68.46174715138362
>>> 41637750/a('na0')
81.29832474226804
>>> 41637750/a('nh0')
75.82632211538461
>>> 41637750/a('nh1')
74.27884615384616
>>> 41637750/a('nh2')
72.79326923076923
>>> 41637750/a('nh3')
71.36595022624434
>>> 41637750/a('nh4')
69.99352810650888
>>> 41637750/a('nh5')
68.67289550072569
>>> 41637750/a('nh6')
67.40117521367522
>>> 41637750/a('nh7')
66.1756993006993
>>> 41637750/a('nh8')
64.99399038461539
>>> 41637750/a('nh9')
63.85374493927125
>>> 41637750/a('n_9')
69.90304709141274
>>> 41637750/a('n_0')
83.00986842105263
>>> 41637750/a('n_0')
83.00986842105263
>>> def bf(d,s):
...     for i in range(10):
...         i, d/a(s+str(i))
...         
>>> bf(41637750,'_n')
>>> def bf(d,s):
...     for i in range(10):
...         print(i, d/a(s+str(i)))
...         
>>> bf(41637750,'_n')
0 83.00986842105263
1 81.3157894736842
2 79.68947368421053
3 78.12693498452012
4 76.6244939271255
5 75.17874875868918
6 73.78654970760233
7 72.44497607655502
8 71.15131578947368
9 69.90304709141274
>>> bf(41637750,'na')
0 81.29832474226804
1 79.63917525773196
2 78.04639175257732
3 76.51607034566403
4 75.04460745440127
5 73.62867146469559
6 72.2651775486827
7 70.95126522961574
8 69.68427835051547
9 68.46174715138362
>>> bf(41637750,'nh')
0 75.82632211538461
1 74.27884615384616
2 72.79326923076923
3 71.36595022624434
4 69.99352810650888
5 68.67289550072569
6 67.40117521367522
7 66.1756993006993
8 64.99399038461539
9 63.85374493927125
>>> bf(41637750,'n_')
0 83.00986842105263
1 81.3157894736842
2 79.68947368421053
3 78.12693498452012
4 76.6244939271255
5 75.17874875868918
6 73.78654970760233
7 72.44497607655502
8 71.15131578947368
9 69.90304709141274
>>> bf(41637750,'n')
0 7885.9375
1 7725.0
2 7570.5
3 7422.058823529412
4 7279.326923076923
5 7141.981132075472
6 7009.722222222223
7 6882.272727272727
8 6759.375
9 6640.789473684211
>>> bf(41637750,'n1')
0 160.9375
1 157.6530612244898
2 154.5
3 151.47058823529412
4 148.55769230769232
5 145.75471698113208
6 143.05555555555554
7 140.45454545454547
8 137.94642857142858
9 135.52631578947367
>>> bf(41637750,'n')
0 7885.9375
1 7725.0
2 7570.5
3 7422.058823529412
4 7279.326923076923
5 7141.981132075472
6 7009.722222222223
7 6882.272727272727
8 6759.375
9 6640.789473684211
>>> bf(41637750,'n_')
0 83.00986842105263
1 81.3157894736842
2 79.68947368421053
3 78.12693498452012
4 76.6244939271255
5 75.17874875868918
6 73.78654970760233
7 72.44497607655502
8 71.15131578947368
9 69.90304709141274
>>> 4345/a('_')
45.73684210526316
>>> 4345/a('O')
55.0
>>> 0xD76A0/a('T_')
110.56842105263158
>>> 0xD76A0/a('T3')
205.9607843137255
>>> 0xD76A0/a('Te')
104.0
>>> 122051160/a('nn')
10086.872727272726
>>> 122051160/a('nnn')
91.69884297520662
>>> 122051160/a('nn}')
80.69498181818182
>>> 122051160/a('nn}')
80.69498181818182
>>> 377910/a('0X')
89.46732954545455
>>> 377910/a('0Y')
88.46207865168539
>>> 377910/a('0Z')
87.47916666666667
>>> 377910/a('0_')
82.875
>>> 0xD76A0/a('_T')
110.56842105263158
>>> 0xD76A0/a('_T')
110.56842105263158
>>> 122051160/a('nnn')
91.69884297520662
>>> 122051160/a('nnc')
101.88760330578512
>>> for i in range():122051160/
  File "<python-input-77>", line 1
    for i in range():122051160/
                               ^
SyntaxError: invalid syntax
>>> for i in range(ord('n'),ord('z')+1):
...     for j in range(ord('n'),ord('z')+1):
...         for k in 'nc':
...             if (type(122051160/a(chr(i)+chr(j)+k)) == int):
...                 print(i, j, k)
...                 
>>> for i in range(ord('n'),ord('z')+1):
...     for j in range(ord('n'),ord('z')+1):
...         for k in 'nc':
...             if (type(122051160//a(chr(i)+chr(j)+k)) == int):
...                 print(i, j, k)
...                 
110 110 n
110 110 c
110 111 n
110 111 c
110 112 n
110 112 c
110 113 n
110 113 c
110 114 n
110 114 c
110 115 n
110 115 c
110 116 n
110 116 c
110 117 n
110 117 c
110 118 n
110 118 c
110 119 n
110 119 c
110 120 n
110 120 c
110 121 n
110 121 c
110 122 n
110 122 c
111 110 n
111 110 c
111 111 n
111 111 c
111 112 n
111 112 c
111 113 n
111 113 c
111 114 n
111 114 c
111 115 n
111 115 c
111 116 n
111 116 c
111 117 n
111 117 c
111 118 n
111 118 c
111 119 n
111 119 c
111 120 n
111 120 c
111 121 n
111 121 c
111 122 n
111 122 c
112 110 n
112 110 c
112 111 n
112 111 c
112 112 n
112 112 c
112 113 n
112 113 c
112 114 n
112 114 c
112 115 n
112 115 c
112 116 n
112 116 c
112 117 n
112 117 c
112 118 n
112 118 c
112 119 n
112 119 c
112 120 n
112 120 c
112 121 n
112 121 c
112 122 n
112 122 c
113 110 n
113 110 c
113 111 n
113 111 c
113 112 n
113 112 c
113 113 n
113 113 c
113 114 n
113 114 c
113 115 n
113 115 c
113 116 n
113 116 c
113 117 n
113 117 c
113 118 n
113 118 c
113 119 n
113 119 c
113 120 n
113 120 c
113 121 n
113 121 c
113 122 n
113 122 c
114 110 n
114 110 c
114 111 n
114 111 c
114 112 n
114 112 c
114 113 n
114 113 c
114 114 n
114 114 c
114 115 n
114 115 c
114 116 n
114 116 c
114 117 n
114 117 c
114 118 n
114 118 c
114 119 n
114 119 c
114 120 n
114 120 c
114 121 n
114 121 c
114 122 n
114 122 c
115 110 n
115 110 c
115 111 n
115 111 c
115 112 n
115 112 c
115 113 n
115 113 c
115 114 n
115 114 c
115 115 n
115 115 c
115 116 n
115 116 c
115 117 n
115 117 c
115 118 n
115 118 c
115 119 n
115 119 c
115 120 n
115 120 c
115 121 n
115 121 c
115 122 n
115 122 c
116 110 n
116 110 c
116 111 n
116 111 c
116 112 n
116 112 c
116 113 n
116 113 c
116 114 n
116 114 c
116 115 n
116 115 c
116 116 n
116 116 c
116 117 n
116 117 c
116 118 n
116 118 c
116 119 n
116 119 c
116 120 n
116 120 c
116 121 n
116 121 c
116 122 n
116 122 c
117 110 n
117 110 c
117 111 n
117 111 c
117 112 n
117 112 c
117 113 n
117 113 c
117 114 n
117 114 c
117 115 n
117 115 c
117 116 n
117 116 c
117 117 n
117 117 c
117 118 n
117 118 c
117 119 n
117 119 c
117 120 n
117 120 c
117 121 n
117 121 c
117 122 n
117 122 c
118 110 n
118 110 c
118 111 n
118 111 c
118 112 n
118 112 c
118 113 n
118 113 c
118 114 n
118 114 c
118 115 n
118 115 c
118 116 n
118 116 c
118 117 n
118 117 c
118 118 n
118 118 c
118 119 n
118 119 c
118 120 n
118 120 c
118 121 n
118 121 c
118 122 n
118 122 c
119 110 n
119 110 c
119 111 n
119 111 c
119 112 n
119 112 c
119 113 n
119 113 c
119 114 n
119 114 c
119 115 n
119 115 c
119 116 n
119 116 c
119 117 n
119 117 c
119 118 n
119 118 c
119 119 n
119 119 c
119 120 n
119 120 c
119 121 n
119 121 c
119 122 n
119 122 c
120 110 n
120 110 c
120 111 n
120 111 c
120 112 n
120 112 c
120 113 n
120 113 c
120 114 n
120 114 c
120 115 n
120 115 c
120 116 n
120 116 c
120 117 n
120 117 c
120 118 n
120 118 c
120 119 n
120 119 c
120 120 n
120 120 c
120 121 n
120 121 c
120 122 n
120 122 c
121 110 n
121 110 c
121 111 n
121 111 c
121 112 n
121 112 c
121 113 n
121 113 c
121 114 n
121 114 c
121 115 n
121 115 c
121 116 n
121 116 c
121 117 n
121 117 c
121 118 n
121 118 c
121 119 n
121 119 c
121 120 n
121 120 c
121 121 n
121 121 c
121 122 n
121 122 c
122 110 n
122 110 c
122 111 n
122 111 c
122 112 n
122 112 c
122 113 n
122 113 c
122 114 n
122 114 c
122 115 n
122 115 c
122 116 n
122 116 c
122 117 n
122 117 c
122 118 n
122 118 c
122 119 n
122 119 c
122 120 n
122 120 c
122 121 n
122 121 c
122 122 n
122 122 c
>>> for i in range(ord('n'),ord('z')+1):
...     for j in range(ord('n'),ord('z')+1):
...         for k in 'nc':
...             if (type(122051160/a(chr(i)+chr(j)+k)) == int):
...                print(i, j, k)
...                
>>> for i in range(ord('}'),ord('}')+1):
...     for j in range(ord('n'),ord('z')+1):
...         for k in 'nc':
...             if (type(122051160/a(chr(i)+chr(j)+k)) == int):
...                print(i, j, k)
...                
>>> for i in range(ord('}'),ord('}')+1):
...     for j in range(ord('n'),ord('z')+1):
...         for k in 'nc':
...             if (int(122051160/a(chr(i)+chr(j)+k)) == 122051160/a(chr(i)+chr(j)+k)):
...                print(i, j, k)
...                
>>> for i in range(ord('}'),ord('}')+1):
...     for j in range(ord('n'),ord('z')+1):
...         for k in 'nc':
...             x = 122051160/a(chr(i)+chr(j)+k)
...             if (x == int(x)):
...                print(i, j, k)
...                
>>> for i in range(ord('n'),ord('z')+1):
...     for j in range(ord('n'),ord('z')+1):
...         for k in 'nc':
...             x = 122051160/a(chr(i)+chr(j)+k)
...             if (x == int(x)):
...                print(i, j, k)
...                
111 119 n
119 111 n
>>> for i in range(ord('n'),ord('z')+1):
...     for j in range(ord('n'),ord('z')+1):
...         for k in 'nc':
...             x = 122051160/a(chr(i)+chr(j)+k)
...             if (x == int(x)):
...                print(chr(i), chr(j), k)
...                
o w n
w o n
>>> 41637750/a('-a')
9539.003436426117
>>> 41637750/a('-an')
86.71821305841924
>>> for i in range(ord('0'),ord('9')+1):
...     for j in range(ord('A'),ord('Z')+1):
...         for k in 'n':
...             x = 41637750/a(chr(i)+chr(j)+k)
...             if (x == int(x)):
...                print(chr(i), chr(j), k)
...                
1 K n
>>> 41637750/a('1Kn')
103.0
>>> chr(103)
'g'
>>> 
